createLevel
wad3
16
82
0,0,0,0,0,0,0,1,0,7,0,0,0,0,0,0,
7,0,7,0,0,0,0,1,0,6,0,0,0,0,0,0,
6,0,6,0,0,0,0,1,0,6,0,0,0,0,0,0,
6,0,0,0,0,7,0,1,0,6,0,7,0,0,0,0,
0,0,0,0,0,6,0,1,0,6,0,6,0,0,0,0,
0,0,0,7,0,6,0,1,0,0,0,6,0,7,0,0,
0,0,0,6,0,0,0,1,0,0,0,6,0,6,0,0,
0,0,0,6,0,0,0,1,0,0,0,0,0,0,0,0,
0,10,0,10,0,0,0,15,0,10,0,10,0,0,0,0,
16,16,16,16,16,16,16,16,16,16,16,16,16,16,16,16,
13,13,13,13,13,13,13,13,13,13,13,13,13,13,13,13,
13,13,13,13,13,13,13,13,13,13,13,13,13,13,13,13,
13,13,13,13,13,13,13,13,13,13,13,13,13,13,13,13,
13,13,13,13,13,13,13,13,13,13,13,13,13,13,13,13,
13,13,13,13,13,13,13,13,13,13,13,13,13,13,13,13,
11,11,11,11,11,11,11,11,11,11,11,11,11,11,11,11,
0,10,0,10,0,0,0,14,0,10,0,10,0,0,0,0,
9,9,9,9,9,9,9,1,9,9,9,9,9,9,9,9,
8,8,8,8,8,8,8,1,8,8,8,8,8,8,8,8,
8,8,8,8,8,8,8,1,8,8,8,8,8,8,8,8,
17,17,17,17,17,17,17,1,17,17,17,17,17,17,17,17,
0,10,0,10,0,0,0,15,0,10,0,10,0,0,0,0,
16,16,16,16,16,16,16,16,16,16,16,16,16,16,16,16,
13,13,13,13,13,13,13,13,13,13,13,13,13,13,13,13,
13,13,13,13,13,13,13,13,13,13,13,13,13,13,13,13,
13,13,13,13,13,13,13,13,13,13,13,13,13,13,13,13,
13,13,13,13,13,13,7,11,13,13,13,13,13,13,13,13,
13,13,13,13,13,13,6,14,11,13,13,13,13,13,13,13,
13,13,13,13,13,13,6,1,10,13,13,13,13,13,13,13,
13,13,13,13,13,13,10,1,10,13,13,13,13,13,13,13,
13,13,13,13,13,13,0,1,0,13,13,13,13,13,13,13,
13,13,13,13,13,13,16,15,16,13,13,13,13,13,13,13,
13,13,13,13,13,13,13,16,13,13,13,13,13,13,13,13,
13,13,13,13,13,13,13,13,13,13,13,13,13,13,13,13,
13,13,13,13,13,13,13,13,13,13,13,13,13,13,13,13,
13,13,13,13,13,13,13,13,13,13,13,13,13,13,13,13,
13,13,13,13,13,13,13,13,13,13,13,13,13,13,13,13,
13,13,13,13,13,13,13,13,13,13,13,13,13,13,13,13,
13,13,13,13,13,13,13,13,13,13,13,13,13,13,13,13,
11,11,11,11,11,11,11,11,11,11,11,11,11,11,11,11,
0,0,0,0,0,0,0,14,7,0,0,0,0,0,0,0,
0,0,10,0,10,0,0,1,0,10,0,0,0,10,0,0,
0,0,0,0,0,0,0,1,0,0,0,10,0,10,0,0,
0,10,0,0,0,0,0,1,0,0,0,0,0,0,0,0,
0,0,0,0,0,0,0,1,0,10,0,0,0,0,0,0,
0,0,0,0,10,0,0,1,0,0,10,0,10,0,0,0,
0,0,0,0,0,0,0,2,0,0,0,0,0,0,0,0,
0,0,10,0,7,0,0,3,0,0,0,0,10,0,0,0,
0,0,0,0,6,0,0,1,0,0,7,0,0,0,0,0,
5,5,5,5,6,5,5,4,5,5,6,5,5,5,5,5,
0,0,7,0,6,0,0,1,7,0,6,0,0,0,0,0,
0,0,6,0,0,0,0,3,6,0,6,0,0,0,0,0,
0,0,6,0,7,0,0,2,6,0,6,0,0,10,0,0,
7,0,6,0,6,7,0,1,0,0,0,0,10,0,0,0,
6,0,6,0,0,6,0,1,0,0,0,0,0,0,0,0,
0,0,6,0,0,6,0,1,0,0,0,0,0,0,0,0,
0,0,0,0,0,0,0,1,0,0,0,0,0,0,0,0,
0,0,0,0,0,0,0,1,0,0,0,0,0,0,0,0,
0,0,0,0,0,0,0,1,0,0,0,0,0,0,0,0,
0,0,0,10,0,0,0,3,0,0,0,0,0,0,0,0,
0,0,0,0,0,0,0,2,0,0,0,0,0,0,0,0,
0,0,0,0,0,0,0,1,0,0,0,0,0,0,0,0,
0,0,0,0,0,0,0,1,0,0,0,0,0,0,0,0,
0,0,0,0,0,0,0,1,0,0,0,0,0,0,0,0,
0,0,0,0,0,0,0,15,0,0,0,0,0,0,0,0,
9,9,9,9,9,9,9,9,9,9,9,9,9,9,9,9,
8,8,8,8,8,8,8,8,8,8,8,8,8,8,8,8,
8,8,8,8,8,8,8,8,8,8,8,8,8,8,8,8,
8,8,8,8,8,8,8,8,8,8,8,8,8,8,8,8,
8,8,8,8,8,8,8,8,8,8,8,8,8,8,8,8,
8,8,8,8,8,8,8,8,8,8,8,8,8,8,8,8,
8,8,8,8,8,8,8,8,8,8,8,8,8,8,8,8,
8,8,8,8,8,8,8,8,8,8,8,8,8,8,8,8,
8,8,8,8,8,8,8,8,8,8,8,8,8,8,8,8,
8,8,8,8,8,8,8,8,8,8,8,8,8,8,8,8,
8,8,8,8,8,8,8,8,8,8,8,8,8,8,8,8,
8,8,8,8,8,8,8,8,8,8,8,8,8,8,8,8,
8,8,8,8,8,8,8,8,8,8,8,8,8,8,8,8,
8,8,8,8,8,8,8,8,8,8,8,8,8,8,8,8,
8,8,8,8,8,8,8,8,8,8,8,8,8,8,8,8,
8,8,8,8,8,8,8,8,8,8,8,8,8,8,8,8,
8,8,8,8,8,8,8,8,8,8,8,8,8,8,8,8,

createPlayer
64
4448
264
4884
hunter
laser

create_enemy(-50,  13, 1, no, 0, 0, no);
create_enemy(-51,  13, 2, no, 0, 0, no);
create_enemy(-105, 13, 3, no, 0, 0, no);
create_enemy(-106, 13, 4, no, 0, 0, no);
create_enemy(-150, 13, 3, no, 0, 0, no);
create_enemy(-151, 13, 4, no, 0, 0, no);
create_enemy(-205, 13, 1, no, 0, 0, no);
create_enemy(-206, 13, 2, no, 0, 0, no);
create_enemy(-250, 13, 1, no, 0, 0, no);
create_enemy(-251, 13, 2, no, 0, 0, no);
create_enemy(-290, 13, 3, no, 0, 0, no);
create_enemy(-291, 13, 4, no, 0, 0, no);

create_enemy(50, 2, 1, no, 0, 0, yes)
create_enemy(50, 2, 2,no,0,0, yes)
create_enemy(50, 1, 3,no,0,0, yes)
create_enemy(50, 2, 4,no,0,0, yes)
create_enemy(50, 5, 5,no,0,0, yes)
create_enemy(150, 1, 1,no,0,0, yes)
create_enemy(150, 1, 2,no,0,0, yes)
create_enemy(150, 1, 3,no,0,0, yes)
create_enemy(150, 1, 4,no,0,0, yes)
create_enemy(150, 3, 5,no,0,0, yes)
create_enemy(250, 2, 1,no,0,0, yes)
create_enemy(250, 2, 2,no,0,0, yes)
create_enemy(250, 2, 2,no,0,0, yes)
create_enemy(250, 2, 2,no,0,0, yes)
create_enemy(250, 5, 2,no,0,0, yes)
create_enemy(350, 6, 2,no,0,0, yes)
create_enemy(450, 5, 5,no,0,0, yes)
create_enemy(450, 1, 0,no,0,0, no)
create_enemy(450, 1, 0,no,0,0, no)
/*
create_enemy(500), scriptpowerup,
			g_POWERUP[s].type = addhealth;
			g_POWERUP[s].change = no;
			g_POWERUP[s].position.x = gridalignment * rand1.RandInt(5,14);
			g_POWERUP[s].position.y = gridalignment * 0;
			SetSpriteState(&g_POWERUP[s], g_POWERUP[s].type);
			g_time++;break;
			g_time++;break;
		}
	}
}
*/
create_enemy(600, 13, 0,no,0,0, no)
create_enemy(610, 13, 0,no,0,0, no)
create_enemy(620, 13, 0,no,0,0, no)
create_enemy(630, 13, 0,no,0,0, no)
create_enemy(640, 13, 0,no,0,0, no)
create_enemy(650, 13, 0,no,0,0, no)
create_enemy(660, 13, 0,no,0,0, no)
create_enemy(670, 13, 0,no,0,0, no)
create_enemy(680, 13, 0,no,0,0, no)
create_enemy(690, 13, 0,no,0,0, no)
create_enemy(700, 13, 0,no,0,0, no)
create_enemy(900, 5, 5,no,0,0, no)
create_enemy(1000, 5, 5,no,0,0, no)
create_enemy(1100, 2, 1,no,0,0, no)
create_enemy(1100, 2, 2,no,0,0, no)
create_enemy(1150, 5, 3,no,0,0, no)
create_enemy(1150, 5, 4,no,0,0, no)
create_enemy(1200, 5, 4,no,0,0, no)
create_enemy(1300, 6, 0,no,0,0, no)
create_enemy(1310, 6, 0,no,0,0, no)
create_enemy(1320, 1, 0,no,0,0, no)
create_enemy(1330, 1, 0,no,0,0, no)
create_enemy(1530, 1, 3,no,0,0, no)
create_enemy(1550, 1, 3,no,0,0, no)
create_enemy(1570, 1, 3,no,0,0, no)
create_enemy(1590, 1, 3,no,0,0, no)
create_enemy(1610, 1, 3,no,0,0, no)
create_enemy(1630, 1, 3,no,0,0, no)
create_enemy(1630, 1, 3,no,0,0, no)
create_enemy(1650, 1, 4,no,0,0, no)
create_enemy(1670, 1, 4,no,0,0, no)
create_enemy(1690, 1, 4,no,0,0, no)
create_enemy(1710, 1, 4,no,0,0, no)
create_enemy(1730, 1, 4,no,0,0, no)
create_enemy(1750, 1, 4,no,0,0, no)
create_enemy(1770, 1, 4,no,0,0, no)
create_enemy(1900, 5, 5,no,0,0, no)
create_enemy(2000, 6, 5,no,0,0, no)

createBoss
100
2048
200
1948
3
level7

loadLevelOnCollision
level7
64
2
