createLevel
wad3
16
82
0,0,0,0,0,0,0,1,0,7,0,0,0,0,0,0,
7,0,7,0,0,0,0,1,0,6,0,0,0,0,0,0,
6,0,6,0,0,0,0,1,0,6,0,0,0,0,0,0,
6,0,0,0,0,7,0,1,0,6,0,7,0,0,0,0,
0,0,0,0,0,6,0,1,0,6,0,6,0,0,0,0,
0,0,0,7,0,6,0,1,0,0,0,6,0,7,0,0,
0,0,0,6,0,0,0,1,0,0,0,6,0,6,0,0,
0,0,0,6,0,0,0,1,0,0,0,0,0,0,0,0,
0,10,0,10,0,0,0,15,0,10,0,10,0,0,0,0,
16,16,16,16,16,16,16,16,16,16,16,16,16,16,16,16,
13,13,13,13,13,13,13,13,13,13,13,13,13,13,13,13,
13,13,13,13,13,13,13,13,13,13,13,13,13,13,13,13,
13,13,13,13,13,13,13,13,13,13,13,13,13,13,13,13,
13,13,13,13,13,13,13,13,13,13,13,13,13,13,13,13,
13,13,13,13,13,13,13,13,13,13,13,13,13,13,13,13,
11,11,11,11,11,11,11,11,11,11,11,11,11,11,11,11,
0,10,0,10,0,0,0,14,0,10,0,10,0,0,0,0,
9,9,9,9,9,9,9,1,9,9,9,9,9,9,9,9,
8,8,8,8,8,8,8,1,8,8,8,8,8,8,8,8,
8,8,8,8,8,8,8,1,8,8,8,8,8,8,8,8,
17,17,17,17,17,17,17,1,17,17,17,17,17,17,17,17,
0,10,0,10,0,0,0,15,0,10,0,10,0,0,0,0,
16,16,16,16,16,16,16,16,16,16,16,16,16,16,16,16,
13,13,13,13,13,13,13,13,13,13,13,13,13,13,13,13,
13,13,13,13,13,13,13,13,13,13,13,13,13,13,13,13,
13,13,13,13,13,13,13,13,13,13,13,13,13,13,13,13,
13,13,13,13,13,13,7,11,13,13,13,13,13,13,13,13,
13,13,13,13,13,13,6,14,11,13,13,13,13,13,13,13,
13,13,13,13,13,13,6,1,10,13,13,13,13,13,13,13,
13,13,13,13,13,13,10,1,10,13,13,13,13,13,13,13,
13,13,13,13,13,13,0,1,0,13,13,13,13,13,13,13,
13,13,13,13,13,13,16,15,16,13,13,13,13,13,13,13,
13,13,13,13,13,13,13,16,13,13,13,13,13,13,13,13,
13,13,13,13,13,13,13,13,13,13,13,13,13,13,13,13,
13,13,13,13,13,13,13,13,13,13,13,13,13,13,13,13,
13,13,13,13,13,13,13,13,13,13,13,13,13,13,13,13,
13,13,13,13,13,13,13,13,13,13,13,13,13,13,13,13,
13,13,13,13,13,13,13,13,13,13,13,13,13,13,13,13,
13,13,13,13,13,13,13,13,13,13,13,13,13,13,13,13,
11,11,11,11,11,11,11,11,11,11,11,11,11,11,11,11,
0,0,0,0,0,0,0,14,2,0,0,0,0,0,0,0,
0,0,10,0,10,0,0,1,0,10,0,0,0,10,0,0,
0,0,0,0,0,0,0,1,0,0,0,10,0,10,0,0,
0,10,0,0,0,0,0,1,0,0,0,0,0,0,0,0,
0,0,0,0,0,0,0,1,0,10,0,0,0,0,0,0,
0,0,0,0,10,0,0,1,0,0,10,0,10,0,0,0,
0,0,0,0,0,0,0,2,0,0,0,0,0,0,0,0,
0,0,10,0,7,0,0,3,0,0,0,0,10,0,0,0,
0,0,0,0,6,0,0,1,0,0,7,0,0,0,0,0,
5,5,5,5,6,5,5,4,5,5,6,5,5,5,5,5,
0,0,7,0,6,0,0,1,7,0,6,0,0,0,0,0,
0,0,6,0,0,0,0,3,6,0,6,0,0,0,0,0,
0,0,6,0,7,0,0,2,6,0,6,0,0,10,0,0,
7,0,6,0,6,7,0,1,0,0,0,0,10,0,0,0,
6,0,6,0,0,6,0,1,0,0,0,0,0,0,0,0,
0,0,6,0,0,6,0,1,0,0,0,0,0,0,0,0,
0,0,0,0,0,0,0,1,0,0,0,0,0,0,0,0,
0,0,0,0,0,0,0,1,0,0,0,0,0,0,0,0,
0,0,0,0,0,0,0,1,0,0,0,0,0,0,0,0,
0,0,0,10,0,0,0,3,0,0,0,0,0,0,0,0,
0,0,0,0,0,0,0,2,0,0,0,0,0,0,0,0,
0,0,0,0,0,0,0,1,0,0,0,0,0,0,0,0,
0,0,0,0,0,0,0,1,0,0,0,0,0,0,0,0,
0,0,0,0,0,0,0,1,0,0,0,0,0,0,0,0,
0,0,0,0,0,0,0,15,0,0,0,0,0,0,0,0,
9,9,9,9,9,9,9,9,9,9,9,9,9,9,9,9,
8,8,8,8,8,8,8,8,8,8,8,8,8,8,8,8,
8,8,8,8,8,8,8,8,8,8,8,8,8,8,8,8,
8,8,8,8,8,8,8,8,8,8,8,8,8,8,8,8,
8,8,8,8,8,8,8,8,8,8,8,8,8,8,8,8,
8,8,8,8,8,8,8,8,8,8,8,8,8,8,8,8,
8,8,8,8,8,8,8,8,8,8,8,8,8,8,8,8,
8,8,8,8,8,8,8,8,8,8,8,8,8,8,8,8,
8,8,8,8,8,8,8,8,8,8,8,8,8,8,8,8,
8,8,8,8,8,8,8,8,8,8,8,8,8,8,8,8,
8,8,8,8,8,8,8,8,8,8,8,8,8,8,8,8,
8,8,8,8,8,8,8,8,8,8,8,8,8,8,8,8,
8,8,8,8,8,8,8,8,8,8,8,8,8,8,8,8,
8,8,8,8,8,8,8,8,8,8,8,8,8,8,8,8,
8,8,8,8,8,8,8,8,8,8,8,8,8,8,8,8,
8,8,8,8,8,8,8,8,8,8,8,8,8,8,8,8,
8,8,8,8,8,8,8,8,8,8,8,8,8,8,8,8,

createEnemy
0
-50
0
-32
1
1
false

createEnemy
0
-75
400
-32
1
1
true

createEnemy
0
-100
0
-32
2
1
false

createEnemy
0
-125
400
-32
2
1
true

createEnemy
0
-150
200
-32
3
4
false

createPowerUp
0
-150
200
-32
0
false

createAlly
0
0
-32
800
exemplar
laser

createAlly
0
0
100
800
sentinel
pulsecannon

createAlly
0
0
300
800
pariah
machinegun

createAlly
0
0
400
800
calumniator
flamethrower

createPlayer
0
0
200
400
hunter
laser